111111111111111111
1000000CC000000011
10000111110000C001
1P0011E00000000001
111111111111111111
