111111111111111111111111111111111111111
1000000CC00111000000CC00111000000CC0011
10000111110000000000CC00000000000CC0011
1P0001EC000011000000CC00111000000CC0011
111111111111111111111111111111111111111
