111111111111111111111111111111111111111111
1110000000000000CCCC0000000001111010101111
1000000000000CCCC0000000001111010101111111
1000000000000CCCC0000000001111010101111111
100000CC00000000CC000000000111101010111111
1000000000000CCCC0000000001111010101111111
1000000000000000C0000000001111010101111111
1000000000000CC000000000111101010111100111
1000000000000CCCC0000000001111010101111111
111111111000000000000000111111111111111111
11111111P000000000000000111111111111111111
111111000000000000000000001111111111111111
111111100000000000000000000011111111111111
100000000000000000000011111111111111111111
100000EC0000000000000011111111111111111111
100000000000000000000011111111111111111111
100000000000000000000011111111111111111111
111111111111110000010001111100000111111111
111111111110000000011111111111111111111111
111111111111111111111111111111111111111111
